xxxxxxxxxxxx
x          x
x          x
x      ?   x
x  x       x
x  xxx     x
x    x     x
x    x     x
x o        x
x    xxxx  x
x          x
xxxxxxxxxxxx